"filename", "language", "ShaderLab", "HLSL", "JSON", "C#", "comment", "blank", "total"
"c:\Users\35109\Desktop\Commonly Used\School\AnimalPokerParty\APP(U3D)\Assets\External Resource\Casino_Environment_Pack\Shader\Glass_Shader.shader", "ShaderLab", 110, 0, 0, 0, 19, 5, 134
"c:\Users\35109\Desktop\Commonly Used\School\AnimalPokerParty\APP(U3D)\Assets\External Resource\Casino_Environment_Pack\Shader\Plants_Shader.shader", "ShaderLab", 63, 0, 0, 0, 56, 5, 124
"c:\Users\35109\Desktop\Commonly Used\School\AnimalPokerParty\APP(U3D)\Assets\External Resource\SCI-FI UI Pack Pro\Common\Scripts\CircleSlider.cs", "C#", 0, 0, 0, 32, 0, 11, 43
"c:\Users\35109\Desktop\Commonly Used\School\AnimalPokerParty\APP(U3D)\Assets\External Resource\SCI-FI UI Pack Pro\Common\Scripts\JustRotate.cs", "C#", 0, 0, 0, 12, 0, 4, 16
"c:\Users\35109\Desktop\Commonly Used\School\AnimalPokerParty\APP(U3D)\Assets\External Resource\SCI-FI UI Pack Pro\Common\Scripts\PressedBtn.cs", "C#", 0, 0, 0, 39, 1, 14, 54
"c:\Users\35109\Desktop\Commonly Used\School\AnimalPokerParty\APP(U3D)\Assets\External Resource\SCI-FI UI Pack Pro\Common\Scripts\SimpleProgress1.cs", "C#", 0, 0, 0, 27, 0, 11, 38
"c:\Users\35109\Desktop\Commonly Used\School\AnimalPokerParty\APP(U3D)\Assets\External Resource\SCI-FI UI Pack Pro\Common\Scripts\SliderRunTo1.cs", "C#", 0, 0, 0, 28, 0, 9, 37
"c:\Users\35109\Desktop\Commonly Used\School\AnimalPokerParty\APP(U3D)\Assets\External Resource\SCI-FI UI Pack Pro\Common\Scripts\SliderValuePass.cs", "C#", 0, 0, 0, 13, 1, 8, 22
"c:\Users\35109\Desktop\Commonly Used\School\AnimalPokerParty\APP(U3D)\Assets\External Resource\TextMesh Pro\Shaders\TMP_Bitmap-Custom-Atlas.shader", "ShaderLab", 109, 0, 0, 0, 2, 33, 144
"c:\Users\35109\Desktop\Commonly Used\School\AnimalPokerParty\APP(U3D)\Assets\External Resource\TextMesh Pro\Shaders\TMP_Bitmap-Mobile.shader", "ShaderLab", 112, 0, 0, 0, 3, 31, 146
"c:\Users\35109\Desktop\Commonly Used\School\AnimalPokerParty\APP(U3D)\Assets\External Resource\TextMesh Pro\Shaders\TMP_Bitmap.shader", "ShaderLab", 109, 0, 0, 0, 2, 33, 144
"c:\Users\35109\Desktop\Commonly Used\School\AnimalPokerParty\APP(U3D)\Assets\External Resource\TextMesh Pro\Shaders\TMP_SDF Overlay.shader", "ShaderLab", 243, 0, 0, 0, 4, 71, 318
"c:\Users\35109\Desktop\Commonly Used\School\AnimalPokerParty\APP(U3D)\Assets\External Resource\TextMesh Pro\Shaders\TMP_SDF SSD.shader", "ShaderLab", 241, 0, 0, 0, 4, 66, 311
"c:\Users\35109\Desktop\Commonly Used\School\AnimalPokerParty\APP(U3D)\Assets\External Resource\TextMesh Pro\Shaders\TMP_SDF-Mobile Masking.shader", "ShaderLab", 188, 0, 0, 0, 10, 50, 248
"c:\Users\35109\Desktop\Commonly Used\School\AnimalPokerParty\APP(U3D)\Assets\External Resource\TextMesh Pro\Shaders\TMP_SDF-Mobile Overlay.shader", "ShaderLab", 183, 0, 0, 0, 8, 50, 241
"c:\Users\35109\Desktop\Commonly Used\School\AnimalPokerParty\APP(U3D)\Assets\External Resource\TextMesh Pro\Shaders\TMP_SDF-Mobile SSD.shader", "ShaderLab", 82, 0, 0, 0, 4, 21, 107
"c:\Users\35109\Desktop\Commonly Used\School\AnimalPokerParty\APP(U3D)\Assets\External Resource\TextMesh Pro\Shaders\TMP_SDF-Mobile.shader", "ShaderLab", 183, 0, 0, 0, 8, 50, 241
"c:\Users\35109\Desktop\Commonly Used\School\AnimalPokerParty\APP(U3D)\Assets\External Resource\TextMesh Pro\Shaders\TMP_SDF-Surface-Mobile.shader", "ShaderLab", 103, 0, 0, 0, 8, 28, 139
"c:\Users\35109\Desktop\Commonly Used\School\AnimalPokerParty\APP(U3D)\Assets\External Resource\TextMesh Pro\Shaders\TMP_SDF-Surface.shader", "ShaderLab", 122, 0, 0, 0, 4, 33, 159
"c:\Users\35109\Desktop\Commonly Used\School\AnimalPokerParty\APP(U3D)\Assets\External Resource\TextMesh Pro\Shaders\TMP_SDF.shader", "ShaderLab", 243, 0, 0, 0, 4, 71, 318
"c:\Users\35109\Desktop\Commonly Used\School\AnimalPokerParty\APP(U3D)\Assets\External Resource\TextMesh Pro\Shaders\TMP_Sprite.shader", "ShaderLab", 97, 0, 0, 0, 0, 20, 117
"c:\Users\35109\Desktop\Commonly Used\School\AnimalPokerParty\APP(U3D)\Assets\External Resource\TextMesh Pro\Shaders\TMPro.cginc", "HLSL", 0, 63, 0, 0, 2, 20, 85
"c:\Users\35109\Desktop\Commonly Used\School\AnimalPokerParty\APP(U3D)\Assets\External Resource\TextMesh Pro\Shaders\TMPro_Mobile.cginc", "HLSL", 0, 122, 0, 0, 2, 34, 158
"c:\Users\35109\Desktop\Commonly Used\School\AnimalPokerParty\APP(U3D)\Assets\External Resource\TextMesh Pro\Shaders\TMPro_Properties.cginc", "HLSL", 0, 62, 0, 0, 10, 14, 86
"c:\Users\35109\Desktop\Commonly Used\School\AnimalPokerParty\APP(U3D)\Assets\External Resource\TextMesh Pro\Shaders\TMPro_Surface.cginc", "HLSL", 0, 76, 0, 0, 7, 19, 102
"c:\Users\35109\Desktop\Commonly Used\School\AnimalPokerParty\APP(U3D)\Assets\External Resource\TextMesh Pro\Sprites\EmojiOne.json", "JSON", 0, 0, 155, 0, 0, 2, 157
"c:\Users\35109\Desktop\Commonly Used\School\AnimalPokerParty\APP(U3D)\Assets\External Resource\Wonky\SimpleTeleportEffect\shaders\TeleportNoise.shader", "ShaderLab", 49, 0, 0, 0, 1, 7, 57
"c:\Users\35109\Desktop\Commonly Used\School\AnimalPokerParty\APP(U3D)\Assets\External Resource\Wonky\SimpleTeleportEffect\shaders\UnlitTextureAlphaColor.shader", "ShaderLab", 68, 0, 0, 0, 1, 9, 78
"Total", "-", 2305, 323, 155, 151, 161, 729, 3824